1      11   1      11      111  1    1  11
1     1     1      1   c    11   1       11
1
1             wwwwwwwwwwwwwwwwwwwwwwwwww
1 s           wwwwwwwwwwwwwwwwwwwwwwwwww   
1             wwwwwwwwwwwwwwwwwwwwwwwwww      e
111111111111111111111111111111111111111111111111
111111111111111111111111111111111111111111111111
111111111111111111111111111111111111111111111111
111111111111111111111111111111111111111111111111
111111111111111111111111111111111111111111111111
111111111111111111111111111111111111111111111111