1
1   s
1               2
1111111111    1111
         122221  1
          1111   1                                    1
                 1       111        111          e    1
                 1    222        222                  1
                 11111111111111111111111111111111111111