1      11   1      11      111  1    1  11
1     1     1      1        11   1       11
1
1
1 s                                           e
1
111111111111111111111111111111111111111111111111
111111111111111111111111111111111111111111111111
111111111111111111111111111111111111111111111111
111111111111111111111111111111111111111111111111
111111111111111111111111111111111111111111111111
111111111111111111111111111111111111111111111111