1      11   1      11      111  1    1  11
1     1     1      1   c    11   1       11
1
1                                       
1 s                                        
1                                            e
111111111111111111111111111111111111111111111111
111111111111111111111111111111111111111111111111
111111111111111111111111111111111111111111111111
111111111111111111111111111111111111111111111111
111111111111111111111111111111111111111111111111
111111111111111111111111111111111111111111111111