1                                                  f              cc          1
1                                                 333                         1
1                                                                1111         1
1                cc                                      1          1         1
1     11                                                     33     1   e     1
1 s 33111111     11                  33311                      33  1  333    1
1     111111     11                     11    333         333       1         1
11111111111111   11                  33311          3331111         1 33333   1
11111111111111   11           11        11                                 3331
11111111111111111111111     1111    111111111                                 1
1111111111111111111111111111111111111111111111111111111111111111111111111111111
1111111111111111111111111111111111111111111111111111111111111111111111111111111
1111111111111111111111111111111111111111111111111111111111111111111111111111111