1                                                                             1
1                                                          f                  1
1                                                                             1
1                                                        11111          e     1
1     11                                                 1                    1
1 s 33111111     11                  33311                      33     333    1
1     111111     11                     11    333         333                 1
11111111111111   11                  33311          3331111           33333   1
11111111111111   11           11        11                                 3331
11111111111111111111111     1111    111111111                                 1
1111111111111111111111111111111111111111111111111111111111111111111111111111111
1111111111111111111111111111111111111111111111111111111111111111111111111111111
1111111111111111111111111111111111111111111111111111111111111111111111111111111