1                   1   1   1
1                   4   4   4  
1
1       3   3                     33
1 s 33        11 3                2             e  
1        2 22211                  1
11111111111111111111  11  11  11111111111111111111
11111111111111111111111111111111111111111111111111
11111111111111111111111111111111111111111111111111
11111111111111111111111111111111111111111111111111
11111111111111111111111111111111111111111111111111
11111111111111111111111111111111111111111111111111