1
1
1
1
1     11
1 s 33111111
1     111111
111111111111                              e
111111111111
111111111111111111111111111111111111111111111
111111111111111111111111111111111111111111111