1    1 1
1
1   1   1
1    111
111111111111111111                    333
1              6                     33333
1 s            6     33      333   222          e  
1        5     6      22   22      111
11111111111111111111111111111111111111111111111111
11111111111111111111111111111111111111111111111111
11111111111111111111111111111111111111111111111111
11111111111111111111111111111111111111111111111111
11111111111111111111111111111111111111111111111111
11111111111111111111111111111111111111111111111111