1                                          1     1     1                 c              1
1                                         11           33331   2                        1
1                              33          1                   1         3              1
1 s                                 33     1                        3                   1
1                       1111               1                                    1       1
111113333111     1111   111122             1                                   21       1
11111 22 111221111111222111111             1                            33  33331       1
111111111111111111111111111111    333331   1                       2            1    3331
111111111111111111111111111111         1   1                    22 333          1       1
11111111111111111111111111111111112222211                       33       33     13      1
11111111111111111111111111111111111111111  S        2      22        22         12    e 1
11111111111111111111111111111111111111111111111111111111111111111111111111111111111111111
11111111111111111111111111111111111111111111111111111111111111111111111111111111111111111