1                                          1                                            1
1                                          1                                            1
1                                          1                                            1
1 s                                        1                                            1
1                       1111               1                                    1       1
11111     11     1111   111122             1                                   21       1
111113311111  1111111   111111             1                            33  33331       1
11111  11111  1111111   111111    333331   1                       2            1    3331
11111  11111  1111111   111111         1   1                    22 333          1       1
11111221111122111111122211111111112222211                       33       33     13    e 1
11111111111111111111111111111111111111111  S        2      22        22         12      1
11111111111111111111111111111111111111111111111111111111111111111111111111111111111111111
11111111111111111111111111111111111111111111111111111111111111111111111111111111111111111