1                                                                                  11                             e    1
1                                                                                  11           22     22         3    1
1                                                                                  113333333333311333331133333         1
1                                                                      3333311     11                        6         1
1                                                              333          11     113                       6      3331
1                                                                           11     11                        62        1
1                                                                     333   11     113333                    6133      1
1  s                                                                        11     11      33          4     6        31
1                                              333             333          11     11           33     4     6         1
1 333   333   333              1111                                         11     11                  4     63333333331
1                        2     1111     333              333                11     11                334     6   2     1
1                        1333  1111333                                      11     11                  4     6 33133   1
1 ccc                          1111                                         11     11           33           6         1
1                            331111                                         11  S                            633   33  1
12222222222222222              1111                                         11                       334     6         1
11111111111111111111111111111111111                                         113333311333333            4     6  333  331
11111111111111111111111111111111111                                         11     11            3333  4     6    c    1
11111111111111111111111111111111111                                         11     11                  4     63333333331
11111111111111111111111111111111111                                         11     11                  4     6         1